15
111111111111111
133333313333331
131131111131131
143333313333341
111111313111111
133331393133331
131133313331131
131111111111131
131133313331131
133331323133331
111111313111111
143333313333341
131131111131131
133333313333331
111111111111111


1-перешкода, 
2-гравець, 
3-монета, 
4-ворог, 
9-вихід.