15
111111111111111
133333313333331
131131111131131
143333313333341
111111313111111
133331393133331
113133313331311
113111111111311
113133313331311
133331323133331
111111313111111
133333313333331
131131111131131
133333313333331
111111111111111