15
111111111111111
100000010000001
101101111101101
100000010000001
111111010111111
100001000100001
110100010001011
110111111111011
110100010001011
100001000100001
111111010111111
100000010000001
101101111101101
100000010000001
111111111111111